tilemap
###################
#                 #
#                 #
#           C     #
#                 #
#                 #
#                 
#    B            
#    B            #
#                 #
#                 #
#                 #
#          @      #
#                 #
#                 #
##########WW#######
/tilemap
legend
    C = chair
    B = desk
    W = window
/legend
